NO d.cub
SO d.cub
WE d.cub
EA       d.cub

C 0,0,33
F 60,0,234


111111111111111111111
1W0000000000000000001
111111111111111111111