NO WALL4.xpm
WE WALL2.xpm
EA WALL0.xpm
SO WALL46.xpm

C 255,255,0
F 0,0,0

11111111
10000001
10000001
1000N001
10000001
10000001
11111111