NO d_wall.xpm
WE WALL2.xpm
EA d_wall.xpm
SO d_wall.xpm

C 0,0,33
F 60,0,234

11111111111111111111
10000000000000000001
10000000000000000001
10000000000000000001
10000000000N00000001
10000000000000000001
10000000000000000001
10000000000000000001
11111111111111111111